40 40
1111111111111111111111111111111111111111
1222                                2221
123                                  321
12                                    21
1                                      1
1                                      1
1                                      1
1                                      1
1                                      1
1                                      1
1                                      1
1                                      1
1                                      1
1                                      1
1                                      1
1                                      1
1                                      1
1                                      1
1                0     0               1
1                0     0               1
1                0     0               1
1                0     0               1
1                0     0               1
1                0  4  0               1
1                0000000               1
1                                      1
1                                      1
1                                      1
1                                      1
1                                      1
1                                      1
1                                      1
1                                      1
1                                      1
1                                      1
1                                      1
12                                    21
123                                  321
1222                                2221
1111111111111111111111111111111111111111
